20 15
1280 960
2 2 2 2 2 2 2 2 2 2 2 2 2 2 2 2 2 2 2 2
2 2 2 2 2 2 2 2 2 2 2 2 2 2 2 2 2 2 2 2
2 3 3 3 3 3 3 1 1 1 1 1 2 0 0 0 0 0 2 2
2 3 3 3 3 3 3 1 1 1 1 1 2 0 0 0 0 0 2 2
2 3 3 3 3 3 3 1 1 1 1 1 2 0 0 0 0 0 2 2
2 3 3 3 3 3 3 1 1 1 1 1 2 0 0 0 0 0 2 2
2 3 3 3 3 3 3 1 1 1 1 1 2 0 0 0 0 0 2 2
2 2 4 4 4 4 2 4 4 4 4 4 2 4 4 4 4 2 2 2
2 1 1 1 1 1 2 0 0 0 0 0 2 1 1 1 1 1 2 2
2 1 1 1 1 1 2 0 0 0 0 0 2 1 1 1 1 1 2 2
2 1 1 1 1 1 2 0 0 0 0 0 2 1 1 1 1 1 2 2
2 1 1 1 1 1 2 0 0 0 0 0 2 1 1 1 1 1 2 2
2 1 1 1 1 1 2 0 0 0 0 0 2 1 1 1 1 1 2 2
2 2 2 2 2 2 2 2 2 2 2 2 2 2 2 2 2 2 2 2
2 2 2 2 2 2 2 2 2 2 2 2 2 2 2 2 2 2 2 2